###################
#*.......#.......*#
#.##.###.#.###.##.#
#........@........#
#.##.#.#####.#.##.#
#....#...#...#....#
####.###.#.###.####
   #.#.......#.#   
####.#.##B##.#.####
.......#P.I#.......
####.#.##C##.#.####
   #.#.......#.#   
####.#.#####.#.####
#........#........#
#.##.###.#.###.##.#
#..#...........#..#
##.#.#.#####.#.#.##
#....#...#...#....#
#.######.#.######.#
#*...............*#
###################
